12 9
000000000
000111000
000111000
000111000
000111000
000111000
000030000
011111110
011111110
011111110
011111110
000000000
3 5 4 5 5 5 4 4
1
archer 1 9 1 1 1


